163
...#..#.##.#.#.#.#.#...####...##...#.##.##.#..#.##.##.###.#..#.....#.#.#.#.####.....####.##...#..#..##..#.#.##.##.#..#.#.#..##......#...#.#.##.#.#...#..#...##...#.
########..##....##....##.....#..##...####..##.......#####.#.##..#..###...#.##..#..####.###..#.#.#...#.#.###.#..#.#########.#...##.#...####.#.......#.#...##..####..
.##.##....##.###..#######..#.##.#.###.#..#.##..#.#.##.##.#.####..###.###...#.....#.###.##....#....####.##..#......#####..#..##..#.#.###...#.#.#..#..#..#..#.#....#.
##.####..####.###.#....##.#.#...#.#..#.#...#.#####..#.#.###.#..#.###....##...#.......##.#..#...##.#.....##.##.#....####.######..#.##.###.###..#..##..#.#.####....#.
#...#.#.#.#..#.##.##..#..#..###.###.#.#####..#...###....####..##...#.#.#####..###.#.#.....#..#..#.#..#.###..####.####.##.####.#.##.####..#..####.#####.#...#...####
.....##.#.#...##...#.#..#..###.....#.####.#.#####.########....####.###......#.#.#...###.####...####..##....#.#.#..###....#.#.###.....##.#....##.#..##.....#.#...#..
...#..#...##.#..##.####.##...#####.####..##..######....##..####.#..#####...#.###..##...#.##.#.#..#...####..###....##....#..###.#..#.#######.###...#..#.#.###.#..#.#
#.#.###...#..##.#.#...##.###...#...###.#####.#.#.#..####.###.##..###..#.#..#.#####..#..#.###.....####.#.##.####..#.##..##.#....#.#.#.#.#.###..#.###.#.#...#.#..#..#
..#...#.####.###.##.##........##...#.###.###....##.###..##..##..#.#.###..##.#...###.#...#.#..####.#..##.#.##..####..##....#.#.######..#.#.##.###.##.#..#..#..###.##
..#.###...#..###...##..#..#...#.#....#..#..##.##.#...##.##.#..##.###..#....#.#.#....#.#...#....#...#.##..##....####...#.#..###.###.##...#.##.#.##..####..####...###
.#.##..######.#######.#.####..###...##...#####...#.#####..###..#.#.##.#..###....##.#.....####.#.###.......#..#####..####.##.#...#...##.##.##..####...#.#.####.##..#
#.#############....#...##.##...##.###.##...#.#..#.#..##...#.#...##.#.#.........#.#####.####..####..##########.#####..##.##.##....##...##.##..#.#.#.....#.#.####....
##.###.###.#####.####....#.....###......###......#.#.........#....#.##..####.##.##.#.#..#.####.#.#.###...##.###.#.##.#....#.....#.#.###...##..##.#..##.##..#..###.#
....###..#.#.....#####..#.#.##.....##..#..####.####..#.#.#.#.#.#...##..##.#.####.###.#..#.......#####.#..#....###.#.#.#.######.....#.#.###.######.###.#....#....##.
#..#.#.##...###...##..#....####...#....#..#.###.#.#....###.###.#.###.#....###..#.####...####.....#..##.#..#..##.#..##.#.#####..#...####.#..###...#.#.#...##.#..#...
.#.....#.###.####.###..#..####.##..#.#.#.#.#.###.#..####...#.####..#.##..##.##.....####..#..#...#..#####.###.#.#....#####...#...#.#.......#.#####.#..#.##.##.###...
.#..##.#..#.#.#....#...#.#.#..####.....#..#....##..#....##.#####.###.......#......#..##.###..#..#.#...##.#.##.##.....#.#.###..##.#.#.#.#.....#......#.#...####.###.
#.#.##.#.##.#####.##.#...##....#.#####.#.###.####.#.##..##.######.#..##..#.###..#######....##.#.##.##..##....#...#...#.##..##.#.##..#.#...#####....#..#...###..##.#
#.###...####..#...##.#..#.....####..##...#.##.#.#.#.##......#.###.#.###.#####.##.##..##..#.##.#........####.#.#.#.##...##....#.####.#...##.#.#.#.###.#.##.#.#.#####
##.##..#..##.#..##....##...........#......#.#...#...#.#.......#..#.##.#......#.....###.##.##..##.###..####..##.#..####..#.####.#...####.#...#..#.#.#.#.##.#.#.#...#
###..#...#..##.#..#.##..#.##.#...#.###.......##.##........###...#.####..##...#.###....#.###.###...#.....#......#..#..#.#...#.#...#......#.....#....###...##..#..###
#...#.####.#.#.###.###.#...######.#.#.#...#....##.......#.#.#..#######.#.#..#.##.##..#.#####.#.#.....##..##.####..#.#.####.#.#..####..#..#.#.......#..#.##.#...#.#.
..##..##.#..#############.##.#..#.##.####....##.##.#..##.##..##.###..######.#...#.##.#....######.##...#....#.#.#.#...####.......##.#####...##..#.#..##....#..#.#..#
#.##.#.###..#......#..#.#..##......#...##.#....#..#.#.#..#.#...##..###.....#.#.###....##....##..#.#.##.###...#####.#...#####.#######..#.##....#.###..###....#..####
..#.####..###.#...#.##.##.#.######.#...#.###..#....####.###....#...#.#..##.##..#.##....###.#..####....#.###.##.#.##.#..#....#......#.#.....##...#..#.....###.####..
.##.####.....#####.#...##.####...##.#.#.#.##..#..##...#...#..#....#.#...#.#..#.#.##..#...#..##.###....##..#.##..##.##.##..##.#.##...####.#.##.#...####.#.#..#.#.###
.####.#.#..#...##.#.....#...#.#.#......##...##..##.#..####..###.#..#....##...#..#.##.#####.#.##...###.#.#...#....#.#..#.###.#..###..##..#.#..###.##.#..#.#####.....
#.#.#.##..##.##...##...##.#.#####.#....#..#.#.#.......#......###.#..#.#.#.....#.###.#..#...#.#......#...###.#.##......####.##..###..#..####...##..#.#.#..#.##.#.#..
##..####.#.#####.####.##..#.#.###.#....###...#..##..######..#..#.#.##.###..#......#....##..#...#..#..###.#..#....#...#.#..#..##.##.#.#...#..#......#.##.#..####..#.
.#.####.#..####.#..##.......#....##....##.#....####.#.##.####.#.#...###.....#.#.####..##..#.#....#.....####...##..###..###..##.#..##...###.#.##....##.##.##..#.#...
#.##...#####.#.#.##....##.......####.#.#.#.#...#.#.....#..#.#..#..#.##...####..##..#..#.###.#..#.#....###....#.##.#.#...##.####.##.#.#.#.......####.#..#.####...#.#
#.#...#..#.#.#####..#.#.#..#.#.##..#.##.#....######.###..##..#.##..#..##..#.#.#.##...#......#..#.#.##..#...#.......#######....#.#..#..#..#.......##......#..#.##.#.
.########..###.#.##.#..#..##....#.##.#..##....#.##.##..#.###.###.#.#.#.#.##.####.#..#.#..##..#......####.#.#.#......#..##.######...#####.#.#...#..#..###.#.#..#..#.
#.###..#...###.##..#.###.#.####.#..##.##.###.##.###.#..#..##..#..#.####....#.##.##........#####..#...##..###.##..#..#...###..#.##.##..####...######.###.#.##.#.#.#.
.#.#.##.###..##.###.#.#..#.##.######..####.##..#.##.##.#.#..###.#.####.#....#.#..###..#.##..##....###...##..####..##..#....###...#..#.#.#.#....#.#######.#.....#..#
#.#.###.###....#.#.##.##..##.###.#.#.##..#..#.###.##.#.###.####.##.##.###.....#..#...##...#..#.#.######.####...#.#...###.##...#.#...####..###...#.#...#.##.###..#.#
.......####.....#..######.###....##.#.####.##....#...###.##.#..##.##.#...#.##..##.##.####.##...#.####.##.###.########.##...#####..#..###...###.#.##.#...##...####.#
#....#####..###.#...##.#...###.###...#.#.....#..##..#####..#...##...#....#.##.#####.###.####..#..#.......####.##.#.#.####.#....##.###..####.....#.##..###.####.#...
#...#....#...##.#.#.#...###.#.......##.#.#...#.#..##...####.##...#..#.#..#..###.######..#.....####.#..#.##.....##..#.####..#.#..#######....#.#...#.....#..#.##..#.#
.#####..#.##.#.##########...##...###........#..###..##.#..#.#..##.#.......#..##.....#.####..#...#.##.#.#.###.##..#..##....####..##.##.####.#.##...#####.#.######.##
#..#.##.###.####..#..#####....##.#.##.#.....###.#..#..#..#.#..#.###.###.##.#..#.#..######..#...#.#.#.#..#.#.##..#....####..#..#....#...##.#.##....#.##.###..#.#..##
.##..###.###.####.#....###.####.#..#..#.#..####....#...##.....#######..#..#......#....###..#.####...#.####.##..#####...#.#...######..#.#...#...#.##..##..#...#..###
.###..##......#...#..####.##......#..#..#..#.#.#.###....##.#....##.#.#.####.##.###.....##.#.##...##..#.#.####...#...#.#.#.#.....###.##.#.#.###.##.#.###....##.#..#.
#...#.#.#.#..#.#.######....#.####.#...#.....###....###...##..##....#..##.#.#.#.##..#.###.#....#.###.#.##.##......##.#..##...#..#..##..#..######...#####..###.#...#.
..##.#.#.#....###.#...#..####.#..#...######....####.#...######...#....####.##.#.####.#.#.#...#.#...#.#.....#.#..######..##.#......#########.##.##..#.#.##..###..###
###.####...###.#..#.#.......#...##....#..#...####.#....#.######.#..#.....#...#...#...#.###..###.##.##..#....#.#.##..#.#.##...#.#..#.##.##..#..##...#..#.#####.##.#.
#....#.###.##..###.##..###.#.#.#....####...##....####.##..#.##.#######..#.....####.######.###..##...##.##.#.#.#####......###..#..###.....#...##....#.##......###...
#..##..##..#.#..#.#.##...###.##.....#.....##.####.##.##.#.#####.#.#.####....#.##.###.####..##.##...######.#..##...###...#####...#...##..####...#.#...#.###..###.###
#.#.#.#.##..##.###.#.##.#..#...#.#...#.#.##.....###.#.######.#######...##.##.##.#.#.#.#.#.##.#.#.#.####.###..####.#....##.####.###.#..#..##......#...#.#.######.#.#
##...#####.###.###.##..##..##..##.###...##...#..#.....##.#.#...###..###..#####........#.#..##...##....###...#..###.##.....###.#.#.....#..#.#.###.######...#..#.####
.....#...###.#.##..####.#.###.##.##.#..#....######.#.##.#..###.#...##..#####.#...###....#.######.#.#.###...##.#.##..##...#.###.###.#.#.#..#.#...#..#..#..####..##.#
#.#.#.###......###.####..#...###...###..#.......#.#....#########.#.##.###....##..#.###.##...######....##.#..#.###..##........#.#..#.#.##....###.#.#..###....##...#.
#.....#.#.#.####.##...........##.#...#.##...###.....#.##.#.#.##.##.#.###..#..#.#.######.##.####...#...###.#...#.###..###.#...#...##...#.##.####..##.#.#.##..#..#.##
#####.#..##.#..##....#..###...#...##.##...##.#.#.#..##.....#.##.#...##..#.###.##.#.#..##....###..#...#..#..###.##..##.##.#....##....#..##..#.#..##...#.#.####..#..#
.#.#.##...##...#.#.#.#.#..#.#.##...##.###.##.##.##.#..###.#.#####.#..###..#....####.#.#......#...##.....##.#####..##..####.##..#.#.##.#.#.#..##.#.#.###..#..##.#..#
#.#######.#.#.#.#.#.#.#########....###.#..##..###...##.#.....##.######.#.#.#.##..#.#.#.###.#.##.#.#...##.##.##.#.#.##.#.###..#......####.####.##.##...#.###........
#....#...######.###.#.#.##.#.##.##.#.#.#.###..#.#..###.###.#..#.#.....##.....#..#.#....######..#..#.#.#.###..#.....#...#.#..#.####...###..###.#...#.##.#....###..#.
..###.##.#....#....##..##....###...#.#.#####..#.#.#...#.....#.#..####..#.#..#.##..##.##...##..#..##.###.##.#.#....#..##.#.####.#..#....#..#........##.##..#.####.##
#.###..#......##.#.#.#......###.###.#.##.##...###..#####.###.#.#..##.#.##..#..##..###.##..#.##.##.#####.########..######....##.###.###..#...##.####.#..##.####....#
#...##.###.#.#.#.#....#.##...#.########..##....#...##..#####.#....#.###...###..###..#####..##.#.###..#...#.#..###.##.##.####...#.##...#.##.##.##....#..##.######..#
...#.#####...#.##..#.##......#.##..#.####.##..##.#......######.#..##.####....##.#.##.###.##..#..##.#.##.##.#.#.####...###.##.#....###.#.##....#.#.#.#.#.##.#..#.#.#
.#...##..#..#.#####.#....#####...##.#.#####.##..###.##.#.#..##...#.##.....#.#.##..##..#.##..##.#.#.###..##.#.#...#.####.#.#.#.#.#.#.#..#####.##.##.#.....##.##.#.#.
.###..######..###..#..#.#..#..#.#..#.####.##.##.##..#..#.#.##.#....#.##.#...#..##.##.#.##....#.#.....#.#.##.#.#.#.#..###.##.#..#####....###.....##.######...#.#.#.#
..#.#.###.#.####.##....###.#.#..#..##..##..##..##..#...##...####....#....####.....#.####...#...###..##.#.#..##.#..###.#.#.###.#.##..####...##.##....#.#.###.#...###
#.##.##..##.##.#.##...#.###.#.#...#.#....#.#.###..#.###...#.#.#.#...#..###....##.#...##..##....#..###.###....##..#..###.#.##..#.#....#..#.###.#.#..###.#.##.#.#.##.
#..#.##.##.##.##.#.####.###...###....#####..#.#...#...####.###..##....#.#..#..##......#####..#.#.########....##.........##.#.#.#....#########.###.#....##.#####..#.
#...######..#..##.#.#.####..##...###.##..##...#..####..#..##..#.###.#...#..#...##.##.#..#.#..#..........##..#..#.#.########..#..#.#####.###..#..#.#...#.....#.#.#..
...####..#...#.###.#..##.#..##.##.....#..#.#...##...#.##.###.##..#...#...###...######.##.....#.##.##..##.#...###.##.#.###..#....###..##.#..####.##.###...####..##.#
##.#..##.#...#.#.#.##.##.###....#..########.#.##.#...##..#########..##.....##.#..#..#..##.###..##.#.##...###.......####.#.#..#......##..##.#..#....###...#..##.#.##
..#..#######.###.#######.#..##.#.##.##...##..#.#...##..##.....#...#.####.....##.###.#...#..###.#.#.###...#.....##.##.#.....#...##.##...######.##...#..#.##.##.####.
#####...#######.#...##......#.#...###.#.#.#..##.#...#..#.#..#####.#.#...#.###.##.#######.#...#.#.#.####.#.#...#.##.#....####..#.####..##.#.###.#..##...######..#.#.
..###.#.##...###...#.#..##..#.##..####...##.##.#...###....##.###..####...#...#.###.#..###.##...###..##...##.#.#..#...#...#..#.###.###..##...###.####.##.#.#..#..###
.#.....###.#.##...####...#...##..###.#..##.#.#...#..#.########.########.##..#..##.#....####.#...#####.#....#....#.##.##..#.#####....#..#..######....#...###..####.#
#.#.#.##.##.####.#.###.#.#.###.##.#.....#.##.###..###.##....###.#..#...#..###.....##..##.###...######....########.#...#..###..........#.#..##..##.##......#......##
.#.#...#.#.#.....#.##..##..#.###.##.#.....##.####...##..#..###.#.....#####...###....#..#.###.####.#.####.##.#.....##..#.#.##.####.###..###....##..#.##..#.###.###..
##..#.#####.##.....#.##..###.####..#.###.......#.#.#.####..#.#.#.##.....#.##.#.#.#.#.#.##.#...#.#.####..#.#...##.#.#..#.#.##..##..##.#.#.#.###...####.#.#.#####....
..######....#.#.....##.##..#.##.##...##..#.#..#.#.#..##.#..####..#..#.##....#.....###.#.....##.###..###....#.###...#...##......#.#...#.....###..#.....#.###..######
###.##..##...#...#......#.#..#.....##...#.#...#.####...#..###.##.##..#.......#.#####.#..#...###.##..#..#.##...###..##.......#.....#.#....#..#.##..#..#.#.###.#...##
#.#.#......##.##..##.#..#.##....####..#..#.##.....###.#.....#..##..#.##.##....#...###.####.....##.##...#...#.#....##.#....###...####.#..##..#..#...##.#.#.#.##..###
##.##.#####..#.###.#....#..##...###.######.###.#....###..####..#######...###.....###.#.####.###.###...###..#..##..##.#.#.#.##...###.#.##..#####.#.##.#.###....#...#
..####..#.####....###...#######...########..###.#####.#.#.##.##...#...##....##..#.#...###.###.#.####.#..###..#.###.#.##...##...#.##..###.#.##.#..#.#.#..#.#....#.#.
....#...#.#.#...###..#.......#.#.####.######.#.#.#.##.#.#..#..#.###.#.#..#.....#....#..........#.#...#......###.##.####.....###.####.###.###..#..#.##.##..####...#.
...#.#####...###.###..#.#......#..#...........#####.##..###.#.#....#..#.##.#...###..####..#....#...####......#.#..###....#.#.#..##.#.#.##.#.####...####...#.######.
#.....#.#####.#.#..#.#.....####.#.##..#.#.##..##..#.#.##.#.....#.#.######.....#...#..##..#..####..#..##..#..#.#...#.#.#.##.#..##...#..###..#.#...#.#.##..#.#.#.##..
#..#..##..#...###.#####.#...######.###.#.....#.####.#.#.###...#.#..#########.##.#...##.##..#..#...##..###.##.#.##....#.#.##.##.######.#.....#..#...##.###..####....
#.#.#.###.##..#.###.###...##.###...#.......#..#.###.#.###.##..#.#.##..#...##.#####..#..#####..##.....#.#.#.#######...#.###.###..##..##.#..##....#.####....#....##.#
....###..#.###.#..#...#.##.....##.#.##.###.#.#..#.##...#.##.##.....#####....###.#...#.####.##.##....###.###.#.#..#.#..#...#..######.###...##.#.#####...####...##.#.
#.####.#..#...#.#..###.#.##.##..#..#.#...##.#...###.#..##.#.###...#.####.##....#...#...#.##.####..#..#.....#.#....#..##.####.#.##.####..###.##..###.#.##.##.....#.#
##..##.####.####...#.#######.#.##...#..####...#..#.#...#...###.##...#..####..####..##.##.#....#####.#.#..#..###.#..#.#..#..##.#.#..###.#...###.##..#.#.##...##.##.#
#.#.....##.####.###....#..#...##.##.##...#...#.#.#.###.###.#.#.....##...#..#..##...##.#..#..#..##.#.....#.###..##.#.#.###.#.##...#.##.#.#.#..###...#..#....#..#....
#.#.##.#..#...#..#.#.###..##.##.#.#..#..##..##.###.##.#....#########.#.####.#.#.#.#...###..##..#.#..#...#..#..##.##...##.#...##.#.#......##.#.########..#..#.#.###.
###.#.#.###.#...#..########...#....##########.#...#.#...###.....#..#.###.###..#....##.#...........##..##.....#....###.##.####.#....######..#..#...#.#.....##.#..#..
#.#.##...#..####........##...#####..#.##.#.#.###.##..#.....##..##.###..##.#.#.#....##.####.###.###.####.#.##.###.#.#####.#....#######....#.#.#...#..#.##..##.##.###
.##.....####..###.##.#..#.#.#.##..#...##..##.#..###..##.##....#..#########.....#..#..###.#..###.####.#.##.###.###.#.#.#...#..#.#.#..#.#.#...##...#.....#..#..######
..#.###....##..##.#.####.#....#..##.#..#.#####.##.#..###..##....##..###...##..###.##.##.#.######..#.##.####...####.#..##.###.###...##.##..#.#.#.###.#..####.#.#....
...###.#.....#...#.##.####.#..###...###.###..#...#.####.............##.#.##.#.#######..#.#.##.##.##..##.###.#..####..###.#.#.###..#..###......#..##..#.#....###.##.
#.##..#.##.###...##.###.#..#.###.#..###.#...#..##..#.#....##..#.....#.###.#.#..#.#..#...##.#...#..#...#...#..#.#.#####.######...##.##.#..#.#.#.#.##.###.#.#.#...###
.##.#.###.....###..####..#...#.#.#....##..##....#.#####..#.##...#...####...#.##.####..####.######.#......###.###.#.##..##...#.##..##.#.###.#....######..######.#..#
#.#...#.##.##...#.#...###.##.#.##.#.#......#.....#....#..#####..#.#.##.....##.####.####.#.#...###.#.#..#...####.#..#.###..#.#.####..##.##....###.#..##.#.###..####.
...#......##.....#.##.#.#.#.#######.........####.#...#.##..#####..#.#####.#.#..#..##.##.##...###...#.#####....#.#...#..#.##.#.#######.#.#.....#..#....#.....#..#.#.
##.#...##..##.##.....#.#..##..###..#.#.###.##.##.###.#...#..#..#..#.###..#.###.#######...##.####..##....###....####..###.###.#..##.####.###...###..#...##...##...#.
.#.#####..##.#.#...##.###.#.#.##.##..##....#...#.#.#...#.#...##..#.#..##..#.#.....##.###.#####.#..##.#.......#..##....##.#.##.######.#.####.##.##.##.#...#..#.#....
.#..#.##.###..#.#.#..........#.#....#####.###.#.##.##..####...##...##.#.....#..####.#.#.##.##..###..###..###..########...###....###.#..#.#...###...#####.....###..#
#########.....#...##.##....##..###...#####...#..###..##..#.##.....###..#.##..#.....#####.#...#....##..#.#.#####.###.#........#..#.##...#.#..#.....####.#..#.#......
..###..##....#..##..#..##.#..###.........#.#..####..#...###.#....###.##..##....##..##....#...##.....##.##.##.#..###.#..#..#.#.......#.#....#.###..##....#.#.##.#.##
##...#.#.#..#.....###.......##.#####.#.#..##.#.#.#.####.#.#.###...#.###.#.##...#.#.##...##.#..##..#.#..###.###.####.##.#.#..####.#.##....##...###...#.#...#.##.#...
##.##.##.#...#.#######...#.##...#..#.#..###..#####...#.#.#.##..#......###.#..####....#####..#.#..##.#.##..#.#.##..#...#.####.##.......#.....#.##.###.#..####..#.###
#..#.#.#.####..#.#....###...#.#.##.#..#.#.#..##.#.##.##.#..#.###.#######..#..#.#..#.#.##....###.#.##..#.##.###.###....#..#..##...#..#.#..#.#.#..##.#..#####.##.###.
..###.#.####..####..##.....##..####.##...##..###.##....#..####......#..#....###.##.#####....##...#...##.##.....##.##.##.####.#######..##.###..#..##...##...###.#.#.
#.#..#.##.######...#...#..#######..##.#.#..#.#...##.#...###.....#.#..############..........##.#..###...#.#.####..##......#.####...#...#.#..######.##.#..#....#...##
.#.##.#...#..#.#....#..#.##.###...#.....#.##.##.##.##..#.#...######.##..####..#.####.#..####..#.#...#.##...#######.#.#...##....#.#..####.#.#...###....#.##.#.##..#.
#.##....#.#.#....#....#...##....#.#.##..##..###......#.####..#.#..###.#...###.###...#..#.####..#..##....#########.#.##...######.#.#....####....###..#.##..###.##.##
###.###.####.###......###.##...#.#.####...####.##.#######..#####.#.#.#####.#.##....###.#..###.....##.#.#.###.##..##..##...##.###........#.##.#.#.##.#####.....#.##.
##.#####..##.###...#......#.#.#....###..####.#..#.####.###..#######..##..##.....###.##...######.#.#.#..##.##......#.#..#..###......#...#...#.####..#.#.####..##.###
##.##.#.###...##...#.#.###..###..##.##..#..#########.#..#...#.####..##.#..###...##.......#..##.#...##.##...#...####.#...#..#..##.#.#.##.##.#..#.##.####.##..#.#####
##.#..#...##....###.#..#..####.#...##....##..##..#..#..#.#.###.#.###.##...######.#.#..#.#..#.#.#.#...#####....#.#####.##.#.#...#..###....#..#..##.###..#..#.###...#
##..######....###.....##.#..#.#..###..####..#.....#...#.#..#....##..#####.#######...#.###......####..###..#.#.##.##.#########.#.#...##...#..###.#..###.##....#.#.#.
##.#####...#..##.#.#..#.#.#.#.#.###...####....#.#..#.###..##..#.##..#..####.#.#...#..#..##......##...#.....###..###..##..##.##..####.####..##.###.#.#.##...#.###.#.
.#.##.#.##..#.#.###.##.###...##.##.###.##.##..#...#...#.##.###........#...#.####..#.....##.#..##.#..##.#..#.#..#.#################..##..###.###...#..#.#..###.#..##
#####..#.##..##...#.#####.##.#.#####.##.#..#..#.#..#...###.#.########.#..#....##......###.##...####...#..##.#......#..#..##.##.###.###.###..#.##.#.#.#..#.####.#..#
#####...#.###.#...#.##...##.#####....#.#.#.#####.#..#.##..###......##..##..#.##.##...##.###.##..###.##.#....##...##....###..#.#...#..##..###.#.######..##.#.#######
##..##.#..#..#.....#.##..#...##..##.#####.##.##..#.##..##.##.....#.#.#.#..#...#..####...##.#.##....#....#..#.#####..#.#....##.##.##...##.#..#.#.###...##.#..#..#.#.
...#...#....###..#.#.#.#.....###.....##.##.#####...#####.##...######.#..###..#.##.#.#..#.##...##.#.#..###...#.#...##...#.#####...#.###.#.##..#.###..#.#..##....##..
......#....##..#.##.#.######..##.##.#..#.##.##.#.##...##.....#...##.##.##.##...##.##..#..###.###..##.##..#.####.##..##.##.#.#.#.#####.##...##..##.#....#....#..####
..#..#..#...##....#.#..##..##.#....##.#...#.##.##.#.#.#.....##..#.###..#.#..##..##..#....#.......###.##....#.....##.#...#...#...####.#.##..##.#.##...#..##..##.##.#
####..#.#.####.#####...#.#........#...##...#...##.#.#..##.#......##...#.#..##.#####.##.#####....##.###..#...###...#...##.##.##.....#.#.###.#.###.#.#.#...#.#....#..
#####.#..#...#.######...#...#..####.#.#..##..####...#.#.####...#.#.#.#......##...#.#.######.##.#####....##.#.##...##...####...###..#....#.#.##..#.##...###...###.##
..####.###.##.#..#.##.##.#.##..#....#........#.#...#....#.....##..#..##..##...#....#...##.#.#####..#..#.#.#...##.##..#.####..#.#..#...#.#.....###.#######.#.#.##...
.###.#...#.##..#...##..#...#.###.#...##..##.##.#...###.#####...##.#.#..##.#.....#.#.#.#.#...#...#...##.#####.....####.#.######.#.###.#.##.##.##..####...##.##..###.
####.#.######..####....##....####.#######...####..#.###...#.#....#..###....##..####.####.#..#.#..#...#####..#.......###.##.###.###.#.###.##......#.###..#.##...####
#....#.##.######.#..###..###...#..##...#..#.#..######.####.###....#...##..##....####...##.#...#....#.............##..#.#.#..##..#.##.#..#.#######..#..#.###.##...#.
..##...##.#######.....#.#...##....#...##....####.##.#.###.###.##..#.##.##.#...#...###.#...#.#.####....#######..#.###....##..#...#.##.#.###.####...######..#..#.##..
..##....####...##.......#..##....####.#.#..#...#....#.....#..#.#...#.#.##.##.##.###..####...###.#..##.#.##..###.#.#.#.....#.#.....##......###.##..##.##.#.#....##.#
###...########...####..##...###..#...#..###.###..#.##.#..#.#..###.###.#.#...#.#..####.##.....#####.##.##..#.#..#...##..#.##..#...##.#.##...#.#..###.#.##.#.#...####
..#.###......#.#..#.#...#..##......####...##.#.#.#.##.#.....#..#.#....#.#..#....#.####..#.....###....#.#..#.##.##..##.##.#####.#.###.#...#.#.#..#####...#.###..###.
######.####.#.....#..#.##.#.###.#......#.#........#.######..##.#...#..##.##.###....###..#...##...##.##.#.....#..#..#.####..##..##...####..###.#...##.#..#.##...#..#
..#.##..#..#...###.####.##...#.....#..####...#.##.#.###.#####.##.#..#.##..#..#.##.#....#.....####.#.#####.####.#..#....#..##.######....#.#..#.##....#..#######.#..#
..#.##..###.#.########....####.#..###.#.##...#.###..#...###.#..#..#..#.#..#...#...##.##.#.#..#####.#....###.##..#....#.#.#.####...#..##...#.....##.#.##..########..
.###.#####.....###..#...###......#....#.##.#..#.#......##.##....#.#..#.#..##.#####.#.####.##.##..#.......##.###...#....####.##.#.#..#...#.#.#...#..#.#...#.#....##.
##########.##.#.########.##.#.###....#####..#.#.#...######..###.#.###.#######....##..###.#...#.#####...###.#.......#..######..#.#.######.#....#..###...###........#
.#.#.#####..##.##.....######.##.##.##...#......##..#.#....#...###...#..#######..#....#....#...##..#.#.#.#.#.#.###.####.#.##..##.##..##....##.#.##..#..#..#...###.#.
.#......##...#..#..##.##.#.####....##.#.#.......###.####.##.#.###.#..#..#..###......#.###.#..#.#.###..##..#.#...##..###....####.....#.#....##.#.##....##....####.##
.#..#...##..##.##..##..###...##..#####.#..##..#..###.##..#.#####.#.....###..##.#####..#.##..#..##..##....#.###......######..##...#.####...###...#.###..#...#......#
.#######.####...#.##..##..#.....##.#.###...#...#.#..##.###..#..#...###.##.##.....##.########......#.###...###.###.##.#.#..#####.#......#...#.##...#.##...##...##.##
##....##...#####...###.#...####.#####.#.#...#.#.#.#..##...#....#...#.#.####..#.###.##########..#.##..#..###.###.##..###.#####..##..###...#.#...##.#........#..#....
##...####..##.##...#..#.###..#...#...##.##.#..#.#####.##.##.....#.....##..#.#...##.#....#.##.#..####.##..#.##..#.........###..#######.####.###.##.#....###..##...##
##..###.###.##.#..##..#.....##...#.####.#.....#.########.#.#..#.#.#..#.###.#.#...####.#.####.#..####....#...##..###.######...#....##.###.#####...###...#.###...#.#.
.#######.####..#######..###.####.#....#.#.#...####...###...###.#.##.#..#..##...##..#.#####..##.#.....####..##...#..###..###..#.##.##..####.##..##....###...###..##.
#.#.##.#.###...###....##.##.####.###......##.#.#.........##.###..#..##..#...#.#.#..##..##.#.###..#.#.###....#.#.#.#....#..###.#..#...###..########.#.....#...#..#..
.#.##.##...##.#.#..##.#####..##.##.#.#..#..#..#....###..#.##.#.###.#...##.##..#.....#.#.#..##...##....##..#.#.#..#.#.#.##.#.###.##.###.#...####...#.#....###..#.###
.####.####.##.#.....###..#...####.#..#...####.######..#..#..###.#......####.....####....#.......#..###..#####.###.#..#...#..#...###..##.#..#.#...##.##.#.####...##.
#.##..##....##.##...#.#..#...#.#.#.#......#####..#....#.....#.....#..#.##.###..##.##.##.#......#..###..#.#.##.#..#....##..#...##.#..#....####..#......#.#.####.##.#
.#..##.#..#...##...###.....#####.....##..#.#####.##.##...#.#.#.#.....##..##.###.#..#.....###......#.....#...#..#..#.#..###.###..#..###.##.......#.#..#.#..#.#...##.
#..#....####.#.#.##..##.#.#.#..#...#.##...#.#.#..#........#...#..###.##.########..#.#.###..###.##.......#.#...#..####.#.##.#..#..#.####.#.###.#####.#.#.###..#....#
##..###..#..###...#.##..##.###.#.##...#.##.##...#.##.##.###..###..#...##...#.#.##....#.##.#..##########.#..####...####.....##..##.###.#..#..#######.###.#.##.....##
..#...#.#..#...###..###.##.#.....###...##..#.....#.#..###..######.........###.####.##.##.#.##..###..#...###.#.#......##...##..######.###..####.##..#.#...#.#.####..
###..#..#...##..#....##..#.#.###.#..#....#.#..#.#.#....##..##.####.......#..#.#########.###...##.#...#....##.##.#...###...#.##.#.###.##..#...##.###...#...#.#.###.#
.##...#...##.#..#...#.####.##....##.#.#.####.#.##....##.#.#.......#..#.#.#...####....#.##.#....#.##.##...#.....#..#...##..#...#.#..#...#.##.####.##.#..###.###.#.#.
#.#...#..####.#.##.##.####.#..##..#.##.......#..#.#..#.#.....##...#####..#.##.#.##.#...####.##.#.#...#.##.#.#.####...###.##..#########..##..#..###.#...####.###.#.#
.##.####.#...#####.#..#.####..###.####....###.####.#.######.##.#...###...#.###..#.####..###..#..#..##..##...##..#.##...####..#.....#...#.#...#..#.###...#..#......#
#........##.##.#..#.#.......##..##.###.###..#.####..###.#...#...###....##.#.#....####.##.##....##..#...###.#..####.###..#.##.##.####......######.#..###.....##..#.#
#.#...##....#.##...#.##..##.##.#..#...#.#.##...#.#...##...#..##.##.#.#..##..#####.###..#####..##.##.##.#.###.#.##.#..###...###..##...#.....##..#.###.#.###.####...#
###.##..#.#.#...##....#.#..##.#...##.#.#.#.#.###..##.#.##.#...#.#..##.####.#...#.##.###.#.###.....#...####..#.##..#####.#...#..#.##...#..#.##..#.#....#.##..#####.#
