10
..........
....######
...####...
..##.##...
.#.##..###
##########
##########
..........
##########
##########